W1 W1 W1 W1 W1 W1 W1 W1 W1 W1 W1 W1 W1 W1 W1 W1 W1 W1 W1 W1 W1
W1 __ __ __ __ __ __ __ __ __ __ __ __ __ __ __ __ __ __ __ W1
W1 __ __ __ __ __ __ __ __ __ __ __ __ __ __ __ __ __ __ __ W1
W1 __ __ __ __ __ __ __ __ __ __ __ __ __ __ __ __ __ __ __ W2
W1 pl __ __ __ __ __ __ __ __ __ __ __ e1 __ __ __ __ __ __ __
W1 __ __ __ __ __ __ __ __ __ __ __ __ __ __ __ __ __ __ __ W2
W1 __ __ __ __ __ __ __ __ __ __ __ __ __ __ __ __ __ __ __ W1
W1 __ __ __ __ __ __ __ __ __ __ __ __ __ __ __ __ __ __ __ W1
W1 __ __ __ __ __ __ __ __ __ __ __ __ __ __ __ __ __ __ __ W1
W1 W1 W1 W1 W1 W1 W1 W1 W1 W1 W1 W1 W1 W1 W1 W1 W1 W1 W1 W1 W1