W1 W1 W1 W1 W1 W1 W1 W1 W1 W1 W1 W1 W1 W2 W2 W2 W1 W2 W1 W1 W1
W1 __ __ __ __ __ __ __ __ __ __ __ __ __ __ __ __ __ __ __ W1
W1 __ __ __ __ __ __ __ __ __ __ __ __ __ __ __ __ __ __ __ W1
W1 __ __ __ __ __ __ __ __ __ __ __ __ __ __ __ __ __ __ __ W2
W1 __ __ __ pl __ __ __ __ __ __ __ __ __ __ __ __ __ __ __ W1
W2 __ __ __ __ __ __ __ __ __ __ __ __ __ __ __ __ __ __ __ W2
W2 __ __ __ __ __ __ __ __ __ __ __ __ __ __ __ __ __ __ __ W1
W1 __ __ __ __ __ __ __ __ __ __ __ __ __ __ __ __ __ __ __ W1
W2 __ __ __ __ __ __ __ __ __ __ __ __ __ __ __ __ __ __ __ W1
W1 W1 W1 W1 W1 W1 W2 W2 W1 W2 W1 W1 W1 W1 W1 W1 W1 W1 W1 W1 W1